10 30
4  4  4  4  4  4  4  4  4  4  4  4  4  4  4  4  4  4  4  4  4  4  4  4  4  4  4  4  4  4
4  1  1  2  1  1  1  1  1  1  1  1  2  1  1  1  1  1  1  2  1  1  2  1  1  1  1  1  1  4
4  1  1  2  1  1  1  1  1  1  2  1  2  1  1  1  1  1  1  2  1  1  1  1  1  1  1  1  1  4
4  1  1  2  1  1  1  1  1  1  1  1  2  1  2  1  1  1  1  2  1  1  1  1  2  1  1  1  1  4
4  1  1  2  2  2  2  1  1  1  1  1  1  1  1  1  1  1  1  2  1  1  2  1  1  1  1  1  1  4
4  1  1  1  1  1  1  1  1  1  1  1  2  1  1  1  1  1  1  1  1  1  2  1  1  1  1  1  1  4
4  1  1  1  1  1  1  1  2  1  1  1  2  1  1  1  1  2  1  1  1  1  2  1  1  1  1  1  1  4
4  1  1  1  1  1  1  1  1  1  1  1  1  1  1  1  1  1  1  2  1  1  2  1  1  1  1  1  1  4
4  1  1  1  1  1  1  1  1  1  1  1  1  1  1  1  1  1  1  2  1  1  2  1  1  1  2  1  1  4
4  4  4  4  4  4  4  4  4  4  4  4  4  4  4  4  4  4  4  4  4  4  4  4  4  4  4  4  4  4